111111111111111
100000020000001
101010121010101
122222222222221
101010121010101
100000020000001
101010121010101
122222222222221
101010121010101
100000020000001
101010121010101
122222222222221
101010121010101
100000020000001
111111111111111
