111111111111111
102002020200001
101010121010101
100202020200201
101010121010101
100002020220021
101010121010101
122002020200221
101010121010101
100202020200001
101010121010101
102020020002221
101010121010101
102000222200001
111111111111111
