111111111111111
100200020002001
101210121012101
122222222222221
101210121012101
100200020002001
101210121012101
122222222222221
101210121012101
100200020002001
101210121012101
122222222222221
101210121012101
100200020002001
111111111111111
