111111111111111
102222222222201
101212121212101
100022222220001
121012121210121
122000222000221
121210121012121
122220000022221
121210121012121
122000222000221
121012121210121
100022222220001
101212121212101
102222222222201
111111111111111
