111111111111111
102202000202201
101212101212101
100202000202001
121212101212121
122222222222221
101212101212101
100202000202001
101212101212101
122222222222221
121212101212121
100202000202001
101212101212101
102202000202201
111111111111111
